XXXXXXXXXXXXXXXXXXXXXXXXXXXXXXXXXXXXXXXXXXXXXXXXXXXXXXXXXXXXXXXXXXXXXXXXXXXXXXXXXXXXXXXXXXXXXXXXXXXXX
X       R R           X                         X   X    R                X   X X             X     X
X XXX  XX X   XXX X X X  X  X X X X  XX    XXXX X X X X X XXXXX X XX XX X   X X     X X  XX X XRX XXX
X               X   XR        X X X           X   X           X  R          XRX   X  R      X X    RX
XXX XX XXXX  XX X X      XXXXXX   X XX  X X X    XXX XXXXX X  XX X XXX   XX X    XX XXXX  X   X X X X
X X       X X   X   X X           X   X         X             X   X         X    R  X R             X
X X   X  X  X     X X   X   X       X XX      X XX  XX  XXX     X X   XXXXX    XX X X XXX XX X XX X X
X   X X R X X       X      RX X   X       X       X   X           X                 X       X       X
X   XX X  X   XXX X X X XX  X X XX  XXX  X  X X X XX  X  X   XXX    X XXX X   X   X  XX   X   X XXX X
X X   X       X     X   R     X   X                 R X             X   X X X X         X     X   X X
X XXX X X X   X   X X XXXXXXX X         X XXX X X XXX XR  XX      XX XXX  X X XXX  X      XX   X  X X
XR              X X           X   X     X X   X     X         X X R      RX X         X   X   X X X X
X X X XX   X X  X XXX X   XXX X X   X   X   X X     X XXX XR  X   X XX  XXX X    XX   X XX    X X X X
X X      R    X X    R        X   XRX X X     X     X    R  X         R       X  RX   X X   X X X X X
XXXXXX  XX    X    XX XXX  R  XX  X X X   XX  X X   X    X   X X XXX  X X XXX   X   X    XX X X     X
X   X       X       X R           X                       X                     X   X     X X X     X
X   X X       X X X   XXXXX XXX X X X   X     X XXX X XXX X XR XX X X XRX X X X XXX    XX X X X     X
X X       X     X X   X   X X       X     X         X   X   X   X           X  RX   X   R           X
XR X X  XX  X X   X X X    X  XX RX X XX       XX   X X   XXXXX XXX X XX XXX  XXX X X X X   XXXXXXXRX
X          RX   X   X   X         X     X X       XR              X   R           X      R          X
X   XXXXXXX   X  X  XXX XXX XXX X XXX   X  X  X       X X     XX  X XXXX     XX XX XX X X X X XX XX X
X       X         X   XR  X            RX             X X   X     X         X         R X  R        X
X X     X   X    RXX        XX  X X X X     XXX   XXX XX XX XXX X X   XX  XXX   X XXXXX X X  XXX XXXX
X X   X       X                 X   X           X   X     X   X X       X     X          RX   X     X
X   X X X     X XX RXX XX   X X   XXXX R XX X X  RX    XX X X X X X X X  X  XXXRX  XX    X XX X X X X
X         X       XR          X       X       R X X           X   X R X     X X   X    R      X   X X
X  X    X X     X XXX    XX X X X XXX XXXXXXX X   XXX   XXXX  X X  XXR  XXXXX   X   X      X XX X   X
X       X       X             X X   X         X X   R              R           R                    X
XR    XX  X X XXXX    XXX XXX   X X X XXX XXXX  X XXXXXX  XX X  X  XXXX  XXXX   XX X  X        XXX  X
X        RX X         X          R  X     X       X R     X    RX                 XR      X X   X   X
X XXX XXX X X XX  X   XRXXX XX  XX  X X X X   X  X  XXXXX   X  XX X X XX        X X XX XX X  XX    RX
X     X   R   X X X   X X X       X X       X       X     X   XR    X  R    X    RX   X    R      X X
X XX     XX XX    X XX    XX  XX XX XXX   X         XX  X XXX  XX   X XXXXX     X XXX   X  XXX XX X X
X   X                         X   X         X     X   XR                X   X      R    X     R X   X
X X  XX X X     X     XXXXXXXXX X   X XXX X     X X    XX X  X      X X   XX   X X  X X X X  X  XXX X
XRX         X   X  RX           X   X     X     X   X X        RX             X   X     X X R       X
X  XX   X X X X X XX           XX XX XX X XXX XX      X X X X XX   XX   X    X  X   X X X X XXXXX   X
X R X X X X       X X R     X     X   X X    R    X       X   X           X     X  R    X   X   R   X
X     X XXXX   XX X XXX  XX X X X X X     XXX   X X XXXX     XX       X X   X X   XX    X       X X X
X      R                  X               X X   X     X   X     X X X     X   XRX   X     X X       X
X X  R   X  XX   X    X  X  X     X XXXXXX  X X  XX X X XXX XXX XX    XXX X   X  XX    XX     X     X
X         X       X X                 X     X XR    X   X    R        X         X X X  R    X X X   X
X     X  XX X X X   X   XX XXX  X X X   X X   XXX X XX    X XXXXX  XX XX XX   X X   XX   XX X     XXX
X     X     X     X XRR X       X   X   X     X   X   X X X     X   X X   X       X   X   X  RX     X
X XX XX  X     XX X   XXX  X   XXX XX  X      X X     X   X X X     XRX X X   X X     XXX XXX X X X X
X        R      X   X X   X X       R     X X X X   X X X       X   X X X   R X X                   X
X X   X X     X   X   X   X    XXXX X X X X X X X X X   XXX    X     RX     X X      XX  XXXX   XX  X
X X         XRX     X X    R  RRX X         X       X     R   X       X   X       XR     R  X   X   X
XXXX XXX XX XXX XXX   X  X    X X   XXXXX    X X  X       X    XX XXX X X X    X XX X X  X  XX RX   X
X                     X   X    R    X   X           X X  R    X   X         XR       R  X X X   X   X
X   X X X X X   XXX    X  X   X X X X X    X  X   XRXR  X XXX   X XRX X X XXXXX X   X  XX   X XXX X X
XR  X      RX  R  X           X X X X X X         X   X X       X             X   X   X     X       X
X X X XX  XXX XXXXXXX XXX X  XX X        XX   XXX     X X  X X X XX X XXXX XX X  X XX X XXX X    XX X
X X R         X   R X       X     X X X     X           X     X               X       X             X
X X X X XXXX XX XXX X   X  X  X   X X  XX X X   XX    X  X       X  X  RX  XXXXX    X XX     X XX X X
X  RX   X  R R  X X     X X             X   X   R   X   XR    X X R   X   X       X   X   X     X   X
XXXXX         X    X  XXX X XXX X   X X X XX  X XXX X X XX      X  X  X XXX X XX    X   X XX  X    XX
X     X       X           X   X X X       X       X           X X     X X       X       X R   X     X
X X  XXX XX X   X     X       X   X  XX X X X XX  XXX X   X XXX XX      X  XX X     XXX X   X X X X X
X X     X   X       X                     X      R                X  RX           X X X   X X       X
XRXX X RX  X XXX XXX    X    XXXX      XX       X X X  X  X X   X  X XX XXX     X     X   X X   X   X
X X         X       X X X X       X X     X X            RX   X   X X   X   X XRX   X     X     X   X
X XXX X XXX   X   X  X  X   XXXX   XX XXXX    X X   X XX  X X     X X  XX XXX   X   X     XX  X   X X
X   X X XR    X X X   X   X  RX     X X     X     X   X X     X X   X  R      XRX     XR  X R   X   X
X   X X     X   X XX        X X  X  X X  X X  X  X XXXX X X X X XRX  XX X X  X   XX X X XX  X X XXX X
X   X   R         X                       X R              RX         X   X R X   X   X       X     X
X  XXX XX X XXXXX   X     XX       XX X   X X X X  X  X X X   XX  XXX  XXXXX  XX   XX  X  X X  XX X X
X  RR     X       X X X   X  RX    R    X X                 X   X   R X   X     X X   X   X       X X
X     X   XX R  XXX     XX  XX    X     X X X    X X XX XX        XXX X X X XXX X     X X X XX  X X X
X           X X         R    RX     X   X   X     R       X X X   X X X X       R X X   X X     X   X
XX XX X  X   XXX    X X XXX     X X  X      X X   X     X X     X X     X       X X   X   XR  XXX X X
X     X X         X  R  X                   X X X     X       X X   X   X X         X    R    X   X X
X XXX     XX XX   XX      X       XX  X XX    X X X XR  X X       X  XXX      XXX  XX   XX  X X   X X
X                 X   X   X     X                   XRX    RX   X        RX X       X X      R  X   X
XRX X XX  X XX  X   X  X XX   X   X X XXX  XXXXXXXXX  X     XX XX X XXX     X  X        X X XRXX XX X
X   X       X   X X     X   X     X X   X                 X           X X     X X     X   X X   X   X
X   X XXX  XX X X XXX   X X     XX RXXX X   XX  X X XX X X XXXX X XXX   X XX X    X X   X  XX   X   X
X   X      RX X X       X       XR      X               X   X   XR  X X X   X         X       X   X X
X     XXXX  X X X X X X   X  X  X XX  XX  XXX  XXXX X X   X X X X X     X      X   XX X      XXXXXX X
E X   X       X   X   X X     X     X X   X         X   X X R X X   X X   R X     X       X     X   X
XXX   X   X X   X     X X  XX X XXX   X X X  X  X X X   X X XX RX X X X XXXX     XX X X    XX X X   X
X   X   X     X     X X                               X         X   X X   X  RX     X   X   XR  X   X
X   X XX    X     X X X   XX    X X   XXX  XX X X X  X  X  XX X X X   XXXXX         X X X         X X
X X       X X     XRX       X   X X X       X    R      X         X X               X X   X      R  X
X  XX X X X    XX     X XX  XXXX  X XX X  X     X   X XXX   XXX X X XXX   X   X X     X   XX    X   X
X X   X X X     X X     X       X X       X   X X   X                   X X X     X X               X
X   X     X   X   X X XXX  X XX XRXXX XX  XXX     X    XXXX  X XX X   X X X X   X XR   XXX      X   X
X   X   X   XR  X X X     X  RX     X           X X X       X     X X         X  R    X         X   X
X X X XXX X    XX X XXXX  X X X X  R  X XX  XXX XXX XX  X X     X   X X XXXXX X  X XX X XX   XX X X X
X X   X R     X X X     X R X   XR  X    R            X       X     X       X           X  RX X  R  X
X X X   XXX   X X X        XXX  X   X X X   XX X  X X X XRX X X X X X XXX XXX  X  XX X    X     XXXRX
X  RX X         X                   X X         X   X             X   X   X       X         X       X
X  X  XXX X XXX   XXX XXX    X  XX  XX XXXXXXXX       XXXXX X XX  X X X  XXR XX      XX XXX X   X XXX
X X   X X     X       X             X         X X X X   R       X X X           X     X   X     R X X
X X X X X XX  X X X  X  X X X  XX X X XXX XXX X X XRXXXXX  XXX    X X X X XX  XXX   XXXXX  XX   X X X
X   X        R  X X     X   X X   X X  R      X X       X         X       X   X       R       X     X
X  XX      XXX  X X X   XR XX XR   X  X XXXX  X  X X XX  X XX XX  X   XX X  XXX X      X XX X X XXX X
X      R  X       X         X R XR          X     X X   X   XRX     X X   X     X X X       X  R    X
XXX XX R  X XXX X X  XXX     X X  XXXXX       XXX     X X   X      XX   X X     X   X   X  X X    X X
X       X     X     X          R          X       X       X   X             X                     X X
XXXXXXXXXXXXXXXXXXXXXXXXXXXXXXXXXXXXXXXXXXXXXXXXXXXXXXXXXXXXXXXXXXXXXXXXXXXXXXXXXXXXXXXXXXXXXXXXXXXXX