XXXXXXXXXX
X        X
X        X
X        X
X   R    X
X    X X X
X XE     X
X      X X
XX       X
XXXXXXXXXX