XXXXXXXXXXXXXXXXXXXXXXXXXXXXXXXXXXXXXXXXXXXXXXXXXXXXXXXXXXXXXXXXXXXXXXXXXXXXXXXXXXXXXXXXXXXXXXXXXXXXX
X           X   R X   X    R        X       X     R     XR  X     X      R  X     X    R    X       X
X XXX XXXXXXX X XXX X X X XXXXXXXXX X X XXXXX X XXXXXXX X X X XRX X XXXXXXX X X XXX XRXXXXXXX X XXX X
X X   X       X     X   X       X   X X X    RX       X   X X X X   X     X X X R   X X     X X   X X
XXX X X XXXXXXXXXXXXXXXXXXXXXXX XRXXXXX X XXXXXXXXXXX XXXXX XRXRXXXXX XXX X XXXXXXXRX X XXX X XXX X X
X   X X X     X         X   X   X X     X R X    RX X X   X XRX     X X   X   R   X X   XR RX   XRX X
X XXXXX XXX XRXXXXXXX XXX X X XXX X X XXXXX X XXXRX X X X X X XXXXX XXX XXXXXXXXX XXX XXX XXX XXX X X
X X     X   X         X   XR  X X X X X    RR X  R  X   X X X X   X   XR            X   X     X   X X
X XRXXXXX XXXRXXXXXXXXX XXXXXXX X XXX X XXXXXXXXXXXXX XXX XXX XRXXXXX XXXXXXXXXXXXX XXXXXXXXX X XXXXX
XR  X R  RX X XR    X   X   R   X   X X X   X       X   X     X X  RX       X R X           XRX     X
X XXX XXXXX X X XXX X XXXXXXXXX XXX X X X XXX XXXXX XXXXX XXXXX X X XXXXXXX X X X XXXXXXXXX XXXXXXX X
X X   X   R X X   X X   X  RX R   X X   X X   X   X     X   X     X     X XR  X X X   X   X X   R X X
X X X X X XXX XXX X X X X X X XXXXX X XXX X XXXRX XXXXX XXX XXXXXXX XXX X XXXXX XXX X XXX XRX XXX X X
X X X X X X   X X X X X   X X X   X X     X   X X       X   X     X   X X  RX X     XRX   X X R XR  X
X X X X X X XXX X X XXX XXX X X X X XXXXX XXX XXXXXXX XXX XXXRXXX XXX X X X XRXXXXXXX X X X X X XXX X
X X X X X X     X XR  X   X X   X X   XR    X       X XRX     XRX     X X X X       X X X X X X   X X
X XXX X XXX XXXXX XXX XXXXX X XXX XXX XXXXXXXXX XXX X XRXXXXXXX XXXXXXX X X XXX XXXXX X XXX X XXX X X
X   X X     X   X   X       X   X   X   X     X  RX X X       X       X X X X   X RRX X   X X X   X X
XXX X XRXXXXX X XXX XXXXXXXXXXX XXX XXX XRXXX XXXXX X X XXXXX X X XXXXX X X X XXX X X XXX X XXX XXX X
X X   X   X X X   X X X    RX   X X     X X   X   X X XR  X X X X     X   X R X R X X X  RX   R XRX X
X XXXXXXX X X XXXRX X X X XXXRXXX XXXXXXX X XXX X X X XXX X XRX XXXXX XXXXX XXX XXX X X XXXXXXXXX X X
X     X X   X  RX   X X X X   X       X   XR    X   X XRX   X X X   X   X   X  RX   X X             X
XXX XRX XXX XXX XXXXX XRX X XXX XXXXX X XXX XXXXXXXXX X XXX X X XXX XXX X XXX XXX XXX X XXXXXXXXXXXXX
X   XRX   X   X X X     X   X R X   X X   X X   X   X XR    X     X X   X X X   XR  XRX   X         X
X XXX X X X XXX X X XXXXXXXXX XXX X X XXX X X X XXX X XXXXXXXXXXX XRX XXX X XXX XXX X XXX XXXXXXXXXRX
XRR X   X X X   X X  RX       X   X   X   X X X   X X    RX   X R   X       X X X     X X         X X
X X XXX XXX X XXX XXX XXXXXXX X XXXXX X XXX X XXX X XXXXX X X XXXXXXXXXXXXX X X XXXXXXX X XXXXXXX XRX
X X   XRX   X R X  RX   X     X X   X   X   X   X X   X   X X   X         X X X   X       X   X     X
XXXXX X XRXXXXX XXX XXXRX XXXXX X X XXXXXXXXXXX X X XXX XXX XXX XXX XXXXX X X XXX XXX XXXXX X XXXXXXX
XR    X X   X X   X R X   XR  X X X    R   R    X X    RX   X X X   X   X X     X   X   X   X XR    X
X XXXXX XXX X XXX X XXXXXXX X X X XXXXXXXXXXXXXXX XXX XXX XXX X X X X X X XXXXX XXX XXXXX XXX X XXX X
X     X X   X X   X X       X X X R   X     X   X   X   X   X   R X X X X XR  X   X         X   X   X
X XXX XXX XXX X XXX X XXXXXXX X XXXXX X XXXXX X XXX XXX XXX XXXXX XXX X XRX X XXX XXXXXXXXXXXXXXX X X
X   X         X X X   X     X     X X X     R X   X   X   X RR  X X   X X X X   X   X X           X X
XXX XXXXXXXXXXX X X XXX XXXXXXXXX X X X XXXXXXXXX XXX XXX XXXXX XXX XXX X XRXXX XXX X X XXXXXXXXXXX X
X X X     XRR   X       X   R X   X X X X X     R X X   X    RX X   X   X   X X X     X   X     X   X
X X XRXXXRX XXXXXXXXXXX X XXX XXX X X X X X XXXXX X XXX XXXXX X X XXX XXXXXXX X XXXXXXXXX X XXX XXX X
X   X R X X   X   X     X   XR  X   X X   X X   X   X R X   X X X   X X       X   X       X   X  RX X
X XXXXX XXXXX X X X XXXXXXX XXX X XXX XXXXX X XXX XXX XXX X X X XXX X XXX XXXXXXX X XXXXX XXX XXX X X
XR R  X   X   X X X X     X X   X X   X  R  X    RX   X X X   X XR  X   X       X X   X   X X X X X X
XXXXX XXX X XXX X XXX X XXX X XXX X XXX XXXXX XXXXX XXX X XXXXX X XXXXX X XXXXX X X X X XXX X X X XXX
X X   X   X     XRR   X X   X X   X X   X   X   X X X   X X   X X     X XR  XRX X X X X     X   X   X
X X XXX X XXXXXXXXXXXXX X XXX X XXX XXX X XXXXX X X X XXX X X X XXXXXRX XXX X XRX X X XXXXX X XXXXXRX
X X X R X X     X    RX X X X X   X     X X   X X X X   X X X X  RX   X   X  RX   X X X     X X     X
X X X XXX XXXRX X XXX X XRXRX XXXXXXXXXXX X X X X X XXX X X X X X X XXXXX XXX XXXXXXX X XXXXX X XXX X
X X X XRX X   X X X   X  RXRX               X   X X   X R R X X X    R  X X         X X     X XRX   X
X X X XRX X X XXX X XXXXX X XXXXXXXXXXXXXXXXXXXXX XXX XXXXXXX XXXXXXXXXRX XXXXXXXXX X XXXXXXX XRX XXX
X     X     X X   X X   X           X   XR    X  RX X       X X   X     X   X   X X XR        X X X X
XXXXXXXXXXXXX XRXXX X X XXXXXXXXXXX X X X XXX XXX X XXXXXXX X X X XXXXX XXX X X X X XXXXX XXXXX XRX X
X   X   X     X X X   X           X   XRX   XR  X   X     X X   X  R  X   XR  X X       X X RR  X X X
X X X X XXXXXXX X XXXXXXXXXXXXXXX XXXXX XXX XXX XXX X XXX X XXXXXXXXX XXXXXXXXX XXXXXXX XXX XXXXX X X
X X   X     X   X       X   X     XR  X   X   XR    X  RX X X       X     X   X     X X   X     X X X
X XXXXXXXXX X XXX X XXXXX X X XXXXX X XXX XXX XXXXXRXXX X X X XXXXX XXXXX X X XXXXXRX XXX XXXRX X X X
X    R    X   X R X       X   X R   X X       X     X   X X       X X  R RX X       X       X X X X X
X XXXXXXX XXXXXXX XXXXXXXXXXXXXXXXX X XXXXXXXXX XXXXX XXX XXXXXXXXX XRXXXXX XXXXXXXXXXXXXXX XXX X X X
X   XR  X       X     X     X       X     X   XR    X X     X  R    X     XR  X   X    RX X R   X X X
XXX XXX XXXXXXX XXXXX XXX X XXX XXXXXXXXX XRX XXXXX XXX XXX X XXXXXXXXXXX XXX X X X XXX X X XXXXX X X
X     X       X X   X     XR    X       XRX X X   X X   X X X     X  RR X   X   X   X   X   X  RX   X
XXXXXRX X XXXXX X XXXXXXXXXXXXXXXXXXX XXX X X X X X X XXX XRXXXXX X X XXXXX X XXXXXXX X XXXXX X XXX X
E   X   X X     X X             X   X X   X X   X X   X    R  X   XRX     X X X       X X   R X X   X
XXX XXXXXXX XXXXX X XXXXXXXXX X XRX X X XXX XXXXX XXXXXXXXXXXXX XXX XXXXX X X X XXXXXXXXX XXXXX XXXXX
X X X       X  R  X     X   X X  RX   X X     X X   X   XR      X X   X   X X XR        XR  X X     X
X X X XXXXXXXXXXXRXXXXX XRXXX XXXXXXX X XXXXXRX XXX X X XXX XXXXX XXX X XXX XXXXXXXXXXX XXX X XXXXX X
XRX X   R X     X  R  X X X   X   X X X     XRX   X   X   XRX R X     X        R R    X   X X     X X
X X X XXXRXXX X XXXXX X XRX X X X X X XXXXX X X X XXXXXXX X X X X XXXXXXXXXXXXXXXXXXX XXX X X X XXX X
XR  X X   X   X  R    XRX X X X X X       X   X X   X   X X X X X   X   X   X   X       X   XRX X   X
X XXX X XXX XXX XXXXXXXRXRX X X X X XXXXXXXXXXXXX X X X X X X X XXX X X X X X X XXXXXXX X XXXXX X XXX
X X   X X   X   X   X     X X X XRX   X           X  RX X X X X   X   X X X   X       X X    R  X   X
X XXXXX X XXXXXXX X X XXXXX XXX X XXXXXRXXX XXXXXXX XXXXX X X XXX XXXXXXX XXXXX XXXXX X XXXXXXXXXXX X
X X R   X       X X   X    RX   X     X XR  X       X R  RX XR  X      R  X   X   X R X             X
X X XXXXX XXXXX X XXXXX XXX X XXXXXXX X X XXXXXXXXXXX XXXXX XXX XXXXXXXXXXX X XXXXX XXXXXXXXXXXXXXX X
X X   X X X   X X X  R  X   XR      X X X    R      X X             X RR  X X   X   X   X   R X   R X
X XXXRX X X X XRX X XXX XXXXXXXXXXX X X XXXXXXXXXXX X XXXXXXXXXXXXXXX XXX X XXX X XXX X XXX X X XXXXX
X     X X   X X   X X   X R     X   X X R   X     X   X             X   X   X   X X R X     X X X   X
XXXXXXX XXXXX XXXXX X XXX XXXXX X XXX XXXXX XXXXX XXXXX XXXXXXXXXXX XXX XXXXX XXX X XXXXXXX XXX X X X
X     X X     X   X X   X X   X   X     XRX X   X  RX   R   X     X     X   X     X   X   X XR  X X X
X XXXRX X XXXXX X XRXXX X X X XXXXX XXX XRX X X X X XXXXX X XXXXX XXXXXXX X XXXXXXXXX X XXX X XXX X X
X XRX X     X   X   X X X   X     X X     X   X X X X   X X R   X         X X         X     X     X X
X X X XXXXX X XXXXXXX X XXXXXXXXX X XXXXXXXXXXX X X X X XXXXXXXRX XXX XXXXX X XXXXX XXXRXXXXXXXXXXX X
X X     X   X X         X   RR    X   X       X   X X XR  X     X   XRX     X X R X X X X   R     X X
X XXXXX XXXXX X XXXXXXX X XXXXXXXXXXX X X XXX XXXXX X XXX X XXXXXXXXX XXXXXXX X XXX X X X XXXXX XXX X
X   X         X   X   X X X   X     X R X X   X   X   X   X X       X       X X   X X   X   R X     X
X X XXXXXXXRXXXXXXX X XXX X XRX XXX XXXXXRXXXXX XRXXXXX XXX X X XXX XXX XXX X XXX X XXXXXXXXX XXXXXXX
X X X   X R X    R  X  R  X X  RX X     X   R X X     X X   X X X R   X R X X     X     R X X R X   X
X X X X XXXXX XXXXXXXXXXXXX XXXXX XXXXX XXXXX X XXX X XRXXX X X XXXXX XXXXX XXXXX XXXXX X X XXX XXX X
X X   XR   R  X         XR    X     X   X R X X   XRX X X   X X   X X X   X   X X     X X     X   XRX
X XXXXXXXXXXXXXXXXXXX X XRXXX XXXXX X XXX XXX XXX X XXX X XXXXXXX X X X X X X X XRXXXXX XXXXXXXXX X X
X X   X     X      RR XRX X   X   X X  RX   XR  X X   X   X R     X XRX X   X   X X     X    R  X X X
X X X X X X X XXXXXXXXX XXX XXX X X XXX X X XXX X XXX XXXXX XXXXXXX X X XXX XXXXX X XXXXX XXXXX X X X
X   X X X X   X     X  RX   X   X     X X X   X   X X       X       X X   X X R   X       X X  RX X X
XXXXX XXX XXXXX XXX X XXX XXXXX XXXXX X XXXXX XXXXX X XXXXXXX XXXXXXX XXX XXX XXXXXXXXXXXXX X XXX X X
X     X   X   X X X R X   X    RX X   X       X     X   XR          X XR  XR RX X          RX   X X X
X XXXXX XXX X X X XXXXX XXX XXX X X XXXXXXXXX XXX X XXX XXXXXXXXXXX X X X X XXX X XXXXXXXXX XXX X X X
X   X   X   X X   X     X   X   X R X       X   X X X X   X       X X X X X   X   X       X X   X X X
XXX XXX X XXX XXX XXXXX X X XXXXX XXX XXXXXXXXX X X X XXX X XXXXX X X X X XXX XXX X XXXXX X X XXX X X
X X X   X X X   X       X X X   X  R  X       X   X   X X X XRX   X    RX   X   X X X   X   X     X X
X X X XXX X X XXXXXXXXXXX X X X XXXXXXX XXX XXXXXXXXX X X X X X XXX XXXXXXXXXXX XXX X X XXX XXXXXXX X
XRX R X X X X X     X   X X   X R X   X X X X     R X X X   X X   X X       X   X   X X   X X       X
X XXXXX X X X X X XXX X X XXXXXXX X X X X XRX XXX XXX X XXXXX XXX XXX XXXXX X XXX XXX XXXXX XXXXXXX X
X         R X   X     X         X R X     X     X               X         X     R X           R    RX
XXXXXXXXXXXXXXXXXXXXXXXXXXXXXXXXXXXXXXXXXXXXXXXXXXXXXXXXXXXXXXXXXXXXXXXXXXXXXXXXXXXXXXXXXXXXXXXXXXXXX