XXXXXXXXXXXXXXXXXXXX
X     RRR     X    X
X  X          X X  X
X X XXXXXX XXXX X XX
X        X   X  X  X
X XX X   X XXX  XX X
X X RXX  X X    X  X
X X X   X  XX XXXXXX
X X X XX     R     X
X   X X            X
X   XX X XXXXX     X
X XXX    R         X
X X XXR  XXXXXX    X
X X    X X   X   XXX
X X R  X XX  XX   XX
XXX RXXX X X  X    X
X XE   X X    X    X
X    XXX X   XXX   X
XX       X   R    XX
XXXXXXXXXXXXXXXXXXXX